11,1,2,2,1,1,4,4,4,4,1,2,2,2,2,2,1,2,1,2,2,1,1,2,1,2,2,2,2,2,2,2,2,1,1,2,1,2,2,1,2,1
11,11,1,2,2,1,4,2,1,4,2,1,1,2,1,2,2,1,1,2,1,2,2,1,1,1,2,1,2,2,1,1,2,1,2,2,1,1,2,1,2,2
1,1,11,2,1,2,4,4,4,4,1,2,2,1,1,2,1,2,2,2,1,2,2,1,2,1,2,2,2,2,2,2,2,2,1,2,1,2,2,2,1,2
2,1,11,2,1,1,1,1,1,2,1,2,2,2,2,2,1,2,1,2,2,1,1,2,1,2,2,2,2,2,2,2,2,1,1,2,1,2,2,1,2,1
1,2,11,2,2,1,1,2,1,2,2,1,1,2,1,2,2,1,1,2,1,2,2,1,1,1,2,1,2,2,1,1,2,1,2,2,1,1,2,1,2,2
1,1,11,11,11,11,1,2,2,2,1,2,2,1,1,2,19,2,2,2,1,2,2,1,2,1,2,2,2,2,2,2,2,2,1,2,1,2,2,2,1,2
2,1,2,2,1,1,1,1,1,2,1,2,2,2,2,2,1,2,1,2,2,1,1,2,1,2,2,2,2,2,2,2,2,1,1,2,1,2,2,1,2,1
1,2,1,2,2,1,1,2,1,2,2,1,1,2,1,2,2,1,1,2,1,2,2,1,1,1,2,1,2,2,1,1,2,1,2,2,1,1,2,1,2,2
